XXXXXXXXXXXXX
XC------O---X
XXX---------X
X----OOO---CX
XXXXXXXXXXXXX